2
3 24 -10
1 20 -50
xxxxxxxxxxxxxxxxxxxxxxxxxxxxxxxxxxxxxxxx
                                       x
xxxxxx  xxxxxxxx   xxxxx   xxxxxx  xxxxx
x  xxx             xxx        xxx  xx  x
x  xxx  xxx   xx   xxx  xxx   xxx  xx  x
x  xxx        xx   xxx  xxx   xxx  xx  x
x  xxx  xxx   xx   xxx  xxx   xxx  xx  x
x  xxx  xxx   xx   xxx  xxx   xxx  xx  x
x  xxx  xxx             xxx   xxx  xx  x
x  xxx  xxx   xx   xxx  xxx   xxx  xx  x
x  xxx  xxx   xx   xxx  xxx   xxx  xx  x
x  xxx  xxx   xx   xxx  xxx   xxx  xx  x
x  xxx  xxx   xx        xxx   xxx  xx  x
x  xxx  xxx   xx   xxx  xxx   xxx  xx  x
x  xxx  xxx   xx   xxx  xxx   xxx  xx  x
x  xxx  xxx   xx   xxx  xxx   xxx  xx  x
x  xxx        xx                   xx  x
x  xxxxxxxxxxxxxxxxxxxxxxxxxxxxxx  xx  x
x                                     Sx
xxxxxxxxxxxxxxxxxxxxxxxxxxxxxxxxxxxxxxxx
